╔══════════════════════════╗
║          Maze            ║
╚══════════════════════════╝
+--+--+--+--+--+--+--+--+--+
   |     |  |     |        |
+  +  +  +  +  +  +--+--+  +
|  |  |        |           |
+  +  +--+--+--+  +--+--+--+
|  |     |     |     |     |
+  +--+  +--+  +  +  +  +  +
|  |  |  |     |  |  |  |  |
+  +  +  +  +--+  +  +  +  +
|  |     |        |     |  |
+  +  +--+--+--+--+  +--+  +
|     |     |     |     |  |
+--+--+  +  +  +  +--+--+  +
|        |     |            
+--+--+--+--+--+--+--+--+--+
